111111111111111
100000000000001
102222002222201
100000000000001
102222002222201
100000000000001
102222002222201
100000000000001
102222002222201
100000000000001
111111111111111
